XXXXXXXXXX
XA       X
X        X
X        X
X        X
X        X
X    B   X
X        X
X        X
XXXXXXXXXX