XXXXXXXXXXXXX
XAo   o   o X
X o o   o   X
X o ooooooooX
X           X
Xooo oo  oooX
X     o     X
X ooooooo o X
X oo  o   o X
X    oB o o X
Xo ooooooo  X
X          oX
XXXXXXXXXXXXX